*****************
*   S****      E*
**** ********* **
** * ****       *
** * **** *******
**   *          *
** *** **********
** *** **********
*      **********
*****************