*****************
*   S****      E*
**** ********* **
** * ****       *
** * ******** ***
**   *          *
** *** ****** ***
** *** ****** ***
*             ***
*****************