*******
*   *E*
* * * *
* * * *
* * * *
* * * *
*S*   *
*******